-X----o---------------------X-----------------oB--o-X------X----B------B-----o-B-----o------o--o-----------o--------------X-oB---X-B---------XBX-oo----------B-------------------o--------------o-------
-o----------o----B---o-------X-----X-B-----X--------X---B----------Xo------o--------B----------------oX--X-X-----oB----------B---o-----X----B-X---o-----------o----------o--B--------X------B-o---B-----
------X----------------------o---------X--------------------B-XB-------o----XX---B---------XB------o-o------o------------------X-o-----o--------------o-----------------oo------o-B------o--B---X---o---
--o-----B-----BX------o---------o-------B-------oB-------------o----o-----------o-oB---XX----B------------o----------B-X----------------o--------------X-----B-o--X-oXo-----B-----X-----B---------------
-------o---X----B------X-----------X--------------B-----XB--B-o--Xo--B------------o-----B---------o--------------------------------B-----------oXo-----------X------XXBBB--X-B--X-B----o--X----B--------
-----o-----o-------B--o-o--o----------o----B----------X-------Bo---------X----oBo---X------o---B-X-------B-----------B--o--o-----o------------B--XXBXXBX---o------o--------------B-----X----------------
------Xo----o-o-X----------B-----------------------------B-----------------------------X---o----------------B------------------------------------B-------o--B-------------X----o-XX------B-------o------
----o--B------Bo-B-B--B---XB-B----o-----BB----------------------------X--o------------B-o-----B------------B---------oX--BX-BXB----o--------------------------o-------------B----------B-o------------Bv
--XBo-------------o---------XX------B-----------X-Xo------B-----B--------oB------B-----------B------------------X-----------------------------------------B----------o--X---------B-------o---------o--f
--X----------------X---X----------------------o-------o--------BB--------B-------------------X-----------------B-------o-------o-------o-----------------B-------XXB---o-o---B----Xoo-o---B------------f
--X--------X-----X--------o--XX-----o-o--XB-------B----BX-------o---------B--------------o--------------------------------X---------------o------X-------o-X-------------B-o------------oX----------B--f
----------------------------o-----------------------------------o--BXX-o-------B--o--B-B--------B------B-------o--X----------B-o----------------o--XX-B-o-------------o-----------B---B-X-BB-BXB-X-----f
-----oo--------X-----------------o-B--o----o----------------B-X-----------------B--o---o---B-------------X-------X---B---------------------B------B----X-------Bo--B---B-----o-------------B-----------f
---------------B----------------------B--B-------o------------XX---B-----Xo---oo--o--------------X-------XB-------------B--------B--o------------------X---------------------Boo-------X---o-----------f
m----X-B-XBE--o--oXoo--o-----------o-X--B-----o--o-o-------------B----X------XEB---------X--------X--o-o--oE--o--------------XX------------------X----X-----oo--B----B-E--X----------X--------BX---X-o-X
XXXXXXXXXXXXXXXXXXXXXXXXXXXXXXXXXXXXXXXXXXXXXXXXXXXXXXX--XXXXXXXXXXXXXXXXXXXXXXXXXXXXXXXXXXXXXXXXXXXXXXXXXXXXXXXXXXXXXXXXXXXXXXXXXXXXXXXXXXXXXXXXXXXXXXXXXXXXXXXXXXXXXXXXXXXXXXXXXXXXXXXXXXXXXXXXXXXXXXX
