-X-B----B-----------B-------B-Xo--o-------BX------------B--o----X--X--------o--X------X--------------------Bo-----------XB------X-B-B----X------o--B----------B--X-X---------B--o-------X------------XB-
-B-X---o-------------------o----------------o---oX--------o-X-------------o--o---XB---------B------------B--Bo--B----Bo-----o------------BB-o-o----------BX------------oo---B---------------XBo-o-----B-
--oo-X--o------------X--B----X----------------X--------X----------B-Bo-------o----------X-B--------o----o--o------X----oX-----o--------o------o-X----o--------------------------X----o----B----X------B-
---o---X--o-----B-----X------oB---o---X------------X---------B-----o-o--B-----o---o----o-B-----------B--------X---------B--o-----------o---o-----X--------B---o-B--XB----Xo---------------X------B----X-
--Bo---X----XBX-B-oXXB-------B-----------X--Boo--B-XBXo----X------------X--X-o--------B--X--X-BB-----------B--------o-BXo---X--------B----B-----------o----XX----o------X-----B---------X-X-----------B-
---X-B-X----X--B-------X----------------B--------X---X-------------B---Bo-X--BX----B--o-----------X-----o-----X-X-o-------------------B-B-B---X-XB----B-------X------X-o-o------X--Xo----------X-----o--
---------o-X--X-----------------B----B-----B---o---------------o-------o--o--oX-----------------------------Bo-X------------------Xo--oX--o---B--------o----X----------X---X--Xo--B-o--------X---oX-----
-o-o--o-----BX-o--o--------X-------BB-X-X--X-------B----B-B----XX-------B------XX----X-----o-o-----B--------o---B-X-----B-X-X---B---B---o-----X-B-------X-oXo-------------X--B-------B---X--o-oX-------v
-o--B---o-------o------oB---oB------Bo-------B-------------X-X----X-----------o---X-X------------o----B--------------------o----o---B----XX--B--X---------------------------X-----o-----------o--X--o--f
------o---o--------o-----------------B-o----------------B-----------X-------------------o---X---o-----X---B------X-----o------------------X--X-oX------B--------------X-XBXXX-----B-B-o----Bo----X-----f
------------B--Xo--o---------------B---X-------B-X--------oX----------B------Bo------B--------o----B--X-B--o-o---X-o------o-----------------XX------o-o--o-----X-------Xo---------B---B-X---B-----B---of
----B-X-o-Xo---X----X--Xo-o----------B-------Xo-B-------X-B---------------o---------o-o-----------BX--X---B-----------------X-X--B--B-o--X---X-----------o-------B--------X-BXXo-----B-----------------f
---o--B---------X------B-----B--o-----B--oB-----B--B---------o--X-----B--X----------o---------------X-------XXBXBB---------X-------oB-B--XooB-B-----------------------X---o--------o----------o----oo-of
mXXXXXXXXXXXXXXXXXXXXXXXXXXXXXXXXXXXXXXXXXXXXXXXXXXXXXXXXXXXXXXXXXXXXXXXXXXXXXXXXXXXXXXXXXXXXXXXXXXXXXXXXXXXXXXXXXXXXXXXXXXXXXXXXXXXXXXXXXXXXXXXXXXXXXXXXXXXXXXXXXXXXXXXXXXXXXXXXXXXXXXXXXXXXXXXXXXXXXXf
XXXXXXXXXXXXXXXXXXXXXXXXXXXXXXXXXXXXXXXXXXXXXXXXXXXXXXXXXXXXXXXXXXXXXXXXXXXXXXXXXXXXXXXXXXXXXXXXXXXXXXXXXXXXXXXXXXXXXXXXXXXXXXXXXXXXXXXXXXXXXXXXXXXXXXXXXXXXXXXXXXXXXXXXXXXXXXXXXXXXXXXXXXXXXXXXXXXXXXXX
XXXXXXXXXXXXXXXXXXXXXXXXXXXXXXXXXXXXXXXXXXXXXXXXXXXXXXXXXXXXXXXXXXXXXXXXXXXXXXXXXXXXXXXXXXXXXXXXXXXXXXXXXXXXXXXXXXXXXXXXXXXXXXXXXXXXXXXXXXXXXXXXXXXXXXXXXXXXXXXXXXXXXXXXXXXXXXXXXXXXXXXXXXXXXXXXXXXXXXXX
