-X----o------------X--------------------------------------B-----B------B-----X-------X------o--o---------------------X---B--o----X-X----------BX--oo---------B---------------------X-------XB---o-------
-o--------------oB---o-------------X------BX------------B-----BX-X---X-----o--o--oo-B----------------oXo-X---------------o-------o----X-------X---------------o----------o--------------------o----B----
-X----X-------------o-o----------------Bo---------------------X--------B----X----B------X--XB------oXoo-----o------------------X-o-X---o--o------X-----------o---o------XoX-----o---o----o----------B---
----------X-------o---B--B----------------o-----o-------------B--------B--------ooo-----X---XB-----X------o----------B-X------------------------X--------o--------X-BXB---B-B-----------o----B-o----o---
-------o--B--o--X------XB----oX----X-------------B----o-XB----o--X-X-------------oo-----B---------o-o---o------------oo--------------------------B--B--------X---B--XBBBBX-o-o--------------------------
-----o----B--------B--B----o------o--------B-----o----X-XXB---B----------X----------X------X----------B--B----X------B---X-----o--------------B--XXBXXBX---o------o------------X-B----oX---------X------
------------X---X--BB-------X----X---------------------X------o----oX------B-B-------------o----------------B-------o----X-----B-B--B--------------------o--B-B----------XXX--oo-----------------o------
----o--B-----------BX------B-----o------B-----------X--B-----X---B----X------B----------B--X--X---B------B-----------o----X-BoB-----------BB------o-----------o--X-B-------------o-----o-X--X----------v
--X-------o-------o-------X--XX-----B----o----B-o--o----B--------oB------oB---X---B----X-------o----B--B----B-B-X----X---B------X----------o--------------B------------o---B-----B--------o---------o--f
---------------o---X---X------------o-----o------------B--B--BBBB--------Bo------------------X---------------BB---B-----XB--BB-o-X-----o----------------X--------X-B-o-B-o---B------o-o---B------------f
-B---------X------o-----oo----X-----o----X-------------BX-o-----X--o-X---------------------o----------------------B------oX----------X--o-o-----------o---------X--------B-----X-------X--------Bo--BX-f
-o--------X-----------------B-----------o----------------------oo-----------------o----B-----X--BX--------------------------B-----------X-----X-o--XX---o--B--X---X-X-------------B---BX---B-B-B-B----Xf
------o---XX---o-----------------o----o-----o-----------------X-o---------------B--o-------------------o-XB------X-------------------------B------Bo---X-o-----B---B---B-----X-------------B----o----X-f
---------X---------------X------------B----o----ooX---------B-X---------B-o----B--------------o------Xo---Bo--------------------o--Bo-o------------------o----------X--------o-o-------X---o-----------f
m-X--------E--X-X-Xoo--o-----B-------X--X-------------X---------------X------X------B-------------X----o--oE--------B-B--X--X-X----X-------------XX----o-----o-------B-E---------o--BX--------o----X---X
XXXXXXXXXXXXXXXXXXXXXXXXXXXXXXXXXXXXXXXXXXXXXXXXXXXXXXX--XXXXXXXXXXXXXXXXXXXXXXXXXXXXXXXXXXXXXXXXXXXXXXXXXXXXXXXXXXXXXXXXXXXXXXXXXXXXXXXXXXXXXXXXXXXXXXXXXXXXXXXXXXXXXXXXXXXXXXXXXXXXXXXXXXXXXXXXXXXXXXX
