-X----o---------------------------------------------------------B------B-------------X---------o----------------------------o----X-B----------BX--o----------B----------------------------------o-------
-o---------------B---o-------------X-------X------------B------------------o--------B----------------oX--X-----------------------o------------X---------------o----------o--------------------o---------
------X-------------------------------------------------------X--------o----X----B---------XB------o-o------o------------------X-o-----o---------------------------------o------o--------o--------------
------------------------------------------------o-------------------------------o-o-----X----B------------o----------B-X------------------------------------------X-BXo-----B-----------B------B--------
-------o--------X------X-----------X-------------B------XB----o--X----------------o-----B---------o----------------------------------------------o-----------X------XBBBBX---o--------------------------
-----o-------------B--B----o---------------B-----o----X-------B----------X----o-----X------------X-------B-----------B------------------------B--XXBXXBX---o------o--------------B-----X----------------
------------X---X--------------------------------------------------------------------------o----------------B--------------------------------------------o--B-------------X---oo-----------------o------
----o--B-----------B-------B------------B--------------B--------------X----------------------------------------------o---BX-BXB----o--------------o-----------o--------------------------o-------------v
--X---------------o----------X------B-----------o--o---------------------oB-------------------------------------X-----------------------------------------B-------------------------------o---------o--f
-------------------X---X---------------------------------------BB--------B-------------------X---------------------------------o-------o-------------------------XXB-----o---B------o-o---B------------f
-----------X------------------X-----o------------------oX-------X---------------------------------------------------------X---------------o------------------------------B--------------------------B--f
----------------------------o-----------------------------------o-----------------o----B--------B--------------------------------------------------XX---o-----------------------------B----B-B-B-------f
------o--------------------------o---------o------------------------------------B--o---------------------X-------X-------------------------B------B----X-------B---B---B-------------------B-----------f
--------------------------------------B----------o------------X-----------o----B--------------------------B-------------------------o------------------------------------------o-------X---o-----------f
m----------E--o----oo--o-------------X--X-----------------------------X------XE-------------------X----o--oE------------------X------------------X-----------o-------B-E-------------X-------------X---X
XXXXXXXXXXXXXXXXXXXXXXXXXXXXXXXXXXXXXXXXXXXXXXXXXXXXXXX--XXXXXXXXXXXXXXXXXXXXXXXXXXXXXXXXXXXXXXXXXXXXXXXXXXXXXXXXXXXXXXXXXXXXXXXXXXXXXXXXXXXXXXXXXXXXXXXXXXXXXXXXXXXXXXXXXXXXXXXXXXXXXXXXXXXXXXXXXXXXXXX
