-X----o---------------------X-----------------oB----X-----------B------B---------B---o------o--o--X----------------------XB-o----X-B---------XBX-oo----------B--o------------------B------------o-------
-o--B------------B---o-------------XB------X--o---------Bo-----------------o--------B----B-----------oX--X-X-----o---------------o-----X----B-X---o--B----B---o----------o-----X--------------o---B-----
------X---------------------------B----X-------------------o--XB-------o----X--X-B------XX-XB------o-o------o------------------X-o-----o--o-----------o-----------------Bo------o-----B--o-----------X--
-----B--------BX------o-----X---o---------------o--------------B----o-----------o-o----XX----B-----------Bo-o---X----B-X-----------------X-------------X-----B----X-oXo-o-o-B---o-------B------B--------
-------o---X----X------X-----------X-----------o-BB-o---XB----o--X-X-B-o----------o-----B---------o---------------B------------------o---------o-o-------B---X------XXBBB----B--Xo-----o----------------
-----o-----o----Bo-B--B----o-X-----X-------B-----o----X-------Bo-o-X------o---o-o---XX-----o---B-X-------B-----------B--o---------------------B--XXBX-BX---o------o--------------B-o---X----------------
------X-----o-o---o--------B------o------------------o--X-------o--B-------------------X---o----------------B----------------------------X-------BX------o--B-------------X----o-----X--X-----X--o------
----o--BBB----Bo---B--B----B---B--------BB-------------B---B---B------X-oo--------o-------------------------------o--o---BX-BXB----o------------B-o--X--------oo-----------------X-----X-o-------------v
--X---------------o----------X------o--------X--o-Xo-B--------o----------oB--------------B----------X-----------X-----------------------oX-----------X----Bo---------o-------------B------o-----X---o--f
--X----------B--B--X---XB------------------o--X----------------BB--B---B-B-------------------X---o---o--X---------------o------o-------o---------------X---------XoB-----o---B--X---o-oo--B-----X------f
-------B---X-o------------o--XX-----o----------B--B----BX-------o---------B---------------------X-------------------------X---------------o------X-------o---------------B--------------o-----------B--f
-----------B----------------oB------------o---------------------o----B-o-------B--o--B-B--------B----------------------------B-o---------B---------XX---o-X-----------o---------------B-X-BBoB-B-X-----f
-----oo--------X-----------------o-B-------o----------------B-X--X--------------B--o---o-------------------------X---B---------------------B------B-X--B-------Bo-XB-X-B-----o-------------B---------B-f
----------------X---------------------B----------o------------X----------Xo---oo---o---------------------XB-------------------------o----------------B-X-----------------------o-------X---o-----------f
m------B--BE--o--oXoo--o----------X--XB-X-----o----o-------------B-E--X------XE----------X--------X----o--oE-o----------------X------------------X---o-------o--B----B-E-----------o-X-----B--B----X---X
XXXXXXXXXXXXXXXXXXXXXXXXXXXXXXXXXXXXXXXXXXXXXXXXXXXXXXX--XXXXXXXXXXXXXXXXXXXXXXXXXXXXXXXXXXXXXXXXXXXXXXXXXXXXXXXXXXXXXXXXXXXXXXXXXXXXXXXXXXXXXXXXXXXXXXXXXXXXXXXXXXXXXXXXXXXXXXXXXXXXXXXXXXXXXXXXXXXXXXX
