---o----oo--B-----------------o-------------o--------------X-------------------------o----B-------------X-B----o-----------------------oB----X--B-B-X-----XXoo-B-o-B--------B---------B----X----B----X--
-B-X--------B-o-B------------------XXBB-X-----X--------X---------X--o-X-------------o-------o---------BB-----B----------o--X------o----------X----XX--X---X-----o--X----B---oBBB------------B---------o-
------X--o------------B--B---o--------B----X-------------X---B------------B-o--BX---B----------B----BooX--o-------X---oo-oB------------BoX------o---B----B------X-----------B---B-------------o------B--
----o-------B---B-o--B-------oo-----B------B-----------B--B-----XX--B-XB-XX-----B-Xo-X--Bo------oB-X-------B-B---o-----------o--B--------------B-o------o------XX----X---B-------X-Xoo-XXo-B---B-o------
-o-----BB--X-o---B---B-B--Xo---X-XB---B--XBXBX-----o----XoB--o-----X--------X--------oX----X-------------oBB-X----X-X---X----X---BB-BXB-----B-----B------o--------------BX-B---o---B--B------B--X--o----
-oB------X--o-----------B---o----X---X-------B---oX---BX--B--------B-------X--B-------BX-B----------o-X-X-------------X-----o--B-oX--o-------o-o---o-X----B--X-----oB-oB-------------X--X--------B--B---
--B---X---oo-----B---X------------Bo-X-----o---B-o--o--o---o---------X---B----------Xoo-----B---o---------X-o-Xo--------B---o---------B--B---X---B--------B----X-----B--B--o------X--B-----o---B----o---
------B--X---------o-B--------o-----------oBo-------X--o---------o--B--------o-o------o------X----o---oB-X-B---o----B-B---B-----oo---o-----o---------o--Booo------B-o---------------------o---------BB-v
--------------B-X---B----Xo------X-------o---o-o-B-----o-----------o---o-----------B------oo--B------o--X-oB---o-----X-----o------X-----B---B-X----X---X-Xo-----X--B-----B---ooX-----B-----------B--X--f
--B----X-X----------------X-------B--------oB-X-B--o----X---o-oX-------------------BoX-B-o--B--B---X-XXB-o-----B-------o------B----X-------o---oB--oo---------B---X-------o-------oB-------B-o---------f
-X-----------------oo----o------------------B---B--X--B--------------B-o----ooXB-X---BB--X------o------XX------B-------------------------------------------B-B-------o--------B--------o-------------o-f
----------X-----o----B-----X-------XXB--------o---B--o--------B-X-----X---X--------o-B-BB---B--B---X------B--B-X-------X-B-o-----o-------o-o-BBXX-------o-------X-------------------BB-----B----B---X-of
----o----X--------------------------X---X-X----o----oX----B-----------X-----oB------------------XX---------o------X---B------oBB-X-------B-------------X--o-o--B-B--------B---o-X-----X----XBX------o--f
-X-----------o---------X--------------o-X-----B---------------XX-Xo------X-----------BXo---------------X-----------X--------oB--B---oX------------o----B----B--B-------o--------X-----X---XBXo--X---X--f
m--X---XBXo------------B-X--o---o--------oB-----o----B----X-XBo----o-Eo-o-----oB-o--------X-B--------oo---XX--X-BE---XB----X------------oX----o---------E-XB------o---X-X---XoB---XE--X-o--o---B---B---X
XXXXXXXXXXXXX----XXXXXXXXXXXXXXXXXXXXXXXXXXXXXXXXXXXXXXXXXXXXXXXXXXXXXXXXXXXXXXXXXXXXXXXXXXXXXXXXXXXXXXXXXXXXXXXXXXXXXXXXXXXXXXXXXXXXXXX--XXXXXXXXXXXXXXXXXXXXXXXXXX--XXXXXXXXXXXXXXXXXXXXXXXXXXXXXXXXXX
