-X----o--------X---X-B------------------------------------------B----X-B-----X-------X--------oo-------------------------B--o----X-XB---------BX--oo---X-----B----B--------X---X--XX------------o----o--
-o----------X---oB---o-------------X-------X------------B-----B------X-----o-Bo--oo-B----------------oXo-X--------B------oX---X--o----X-------XX------B-------o----------o--------------------o----B----
------X-------------o-------------------o-----X---------------X------B-B----X----B---------XB------oXo------o----B-------------X---XB--o--o--------o---X-----o---o---B--XoXX----o--------o----------B---
----------X-----------B-------------------oX----o----------------------B--------ooo-----X----B--X--X------o---o------B-X------------B-----------B------------B----X-BXB---B-B----------oB------B--------
-------o--B--o--X------XB----o-----X-------------B------XB----o--X----X----------oo-----B---------o-----o-------------o-X-------------X----------o-----------X------XBBBBX---o--------------------------
-----o--B-B--------B--B----o------o--------B-----o----X-XXB---B----------X---o------X--B---X-------------B----X-o----B----------B---X---------B--XXBX-BX---o----B-o--------------B-----X----------------
----X-------X---X-----------X---X-X--------------------X------o----oX-------o--------------o--X-------------B------------X-----B----o----o---------------o--o------------XXX--oo--X--------------o------
----o--B-o---------BX------B------------B-o---B-----X--B----------X---X------B----------B-----X----------B-------o---X----X-BoB-------------------o-----------o--X-----o---------o-------X-------------v
--X-------o-------o-------X--XX-----B-----------o--o----BX--------BB-----oB---X--------X-------o----B-----------X--------B--o---X----------o--------------B------------o---------BB-------o---------o--f
---------------o---X---XB-----------o-----X------------B--X--B-BB-----o--B-------------------X------------X--BB---B------o--B--o-------o----------------X--------XoB---BXo---B------o-o---B-o----------f
-B-o-------X------X-----------X---o-o----X-------------oX-------X-------------------o------oB---------------------B------oX----------X--o-o-----B-o-------------X--------B-------------X--------Bo--BB-f
-o--------Xo---B-------------------------------o-B--------------o-----------------o----B-----X--BX-------------------------------------------o--oo-XXB--o--B--------------X-------B---BX---B-B-B------Xf
------o---X----o------------B----o---------------B------------------------------B--o----X------------B-o-X-------X-------------------------B-o----Bo---XBo-----B---B---B-----X-------------B--B------X-f
---------X----------------------------B---X-----oo------------X--------B--o----B------------X--------Xo---Bo---------------------X-B------B--------------o----------X--------o-o-------X---o-----------f
m-X-----B--E--o-X--oo--o---B---------X--X-----------------------------X------X--------------------X----o--oE-------------X--X-X----X-------------XX----o-----o-------B-E---o-----o--BX--------o----X---X
XXXXXXXXXXXXXXXXXXXXXXXXXXXXXXXXXXXXXXXXXXXXXXXXXXXXXXX--XXXXXXXXXXXXXXXXXXXXXXXXXXXXXXXXXXXXXXXXXXXXXXXXXXXXXXXXXXXXXXXXXXXXXXXXXXXXXXXXXXXXXXXXXXXXXXXXXXXXXXXXXXXXXXXXXXXXXXXXXXXXXXXXXXXXXXXXXXXXXXX
