------o--X---B----------B---X--XX---X---------X-X----B-----o-----------------o---X---o------------BX---------BB------o--XXo----B---X---o-X-------oB-Xo----B-----B-X----B--------X-----BXX-XX---BB--o----
-BX---------B-o-----------------------o--B-----X-----X-Xo--X-BX-o----------XX--------B----XXo--X--o----B-o-----X----------BX------BX-------o-----XXX-oX-oo----------o--XB---o-o-X--B----oB--B-X-----X---
-----oXo-----o-BX-B-----o--B-------X----------X-X--------BX--o--------------o---X------------XX----o--oX-Xoo--o--o-o---o-o-X---------------------o--X--XB-B--B---o----------B---B-B----XX-----o-o-B--X--
----oX-----oB---B--XXB-B-----oo--X--X---B--B----o------o---o--------B-oB-X--o---XBXX----Bo-------B-X--X--o--X--------B-----o----B----XB---------------o---------XX---BoB---------X--oB--X------B----BB--
-BX-----B-o------------B--XoBX-B-X--XX---XBXBX-X---XX---X-XB-o--o---o---------o-----------B---X--X--------B--o--Bo---------------B--oXB-oB--B----BB------X-X-B-XB---B---------------------------Xo------
--B-------o--o--X----B--B-----o--B---X------B----------------------B---o---X--------------o-----oo--B-o--------o--B---X-----o--B-o-B---------------oX----------B--X-B-X--------------XBX----BX----------
---o--X---Xo----------------------Bo------B--B---------o-B---X---------B-o-B--------X-B------oo-----oX---o--B--o--o-----BooB--B-----o-B-o----X----X----X------------X---------XX-BX-----X-----oBB-o-o---
-o------o--B---oX--o-o---------X----------oB--------X-X----------o-----B---X---o-----B--------B--------B-X-----o------BX---------o---o-o------------o-----XX---B----o---B---------------X-B--B----B-BBXv
-X----------XoBB-oB-B----------------oX-----oo-oXB-------------------------X-B----o-----------X--o-o-------B--X----------o-o------------------B---B-------oX-B-X---B---------o-----X----------o--------f
-------B--o----------X-B---BX----------------B-XBo-B--o-----B--X-------o-B-B-------Bo--B---o-------X---o-------B-------B----B----------o-X--------Boo--o--B-------X---o------X--oX-B---B-o-X-X---------f
-o-o-o--------X----o---X-X----o----X--oB--------B-B------X--B---X---X---o-B-o-XB-----X---X--o--X--B-B-X---------BX--X--B---BX--X----------X--------o-----B-------X---X--BB-B-----o----o-X-X------X-----f
--oB---o--X----o------B--B-o-B------------------X-B--B--------B-X-----X-------------B--Bo--oX--B--oX-X---BB--B-Bo-o-oo-X--Bo--B--X---------------B-X--B----o---B---X--o-------------B-X---BB---B---BX-of
-----o---X------XB----oo---X-------XX---X-X----o--X------XB-oB--------------o----B--Xo---------oXXX-------X---B---X----------o-X-X-------XB------X---------------B---o---XBooo---o----X----X--o-X---o--f
-X--------B--o--o---o----B---------oB-B-X-----B-----X-X-o-B---X-X--X--------Xo-oBB--o--------------X---X-----o--X---------BBoX------oX--X------B---B---------XX---------------X-o--B------BoX---B---X--f
m---X--X-X---------X--------B---X-B------o---B-o--B-BBBo----XX-o---o-Eo----o---B-B---o----------BB---o----XB-oBBBE---------X---B-BB----------------o----E---------o---X-----------oE----BB----o-Bo----XX
XXXXXXXXXXXXX----XXXXXXXXXXXXXXXXXXXXXXXXXXXXXXXXXXXXXXXXXXXXXXXXXXXXXXXXXXXXXXXXXXXXXXXXXXXXXXXXXXXXXXXXXXXXXXXXXXXXXXXXXXXXXXXXXXXXXXX--XXXXXXXXXXXXXXXXXXXXXXXXXX--XXXXXXXXXXXXXXXXXXXXXXXXXXXXXXXXXX
