-X----o------------X--------------------------------------------B------B-----X-------X-o-------B-------------------------B--o----XBX----------BX--oo---------B---B----o------------X------------o-------
-X-------------ooB---o-------------X-----o-X------------B-----B------B-----o--o--oo-B----------------oXo-X---o----X------o-------o----X-X-----X-B---B---------o----------o--------------------o-X-BB----
------X-------------o-------------------o------------B---X-X--X--------B----X----B---------XB------oXo--B---o--------------------o-X---o--o------------------oo--o------XoX-----o--B-----o----------B---
----------X-----------B----------B--------o-----o--------X-------------B--------ooo-----X----B-----o-X----o----------B-B------------------------B-----------------X-BXB---B-BX----------B------B--------
--B----o--B--o--X------XB----o-----X-------------B------XB---oo--X---------------oo-----B-o-------o-----o-------------o--------------------------o-----------X------XBBBBX---o--------------------------
-----o----B--------B-XB-o---------oo-B-----B-----o----X-XXB---B------X---X----------X------X---------o---B---oX------B---X-----X--------------B--XXBXXBX---oo-----o--------------B-----X---B------------
------------X---X-----------X--------------X--B---B--B-X------o----oX------------------o---o----------------X------------X----------B----------o---------o--B-B----------XXX--oo-----------------o------
----o--B----o-o----BX---B--B------------B-----------X--B--------------X------B----------B-----X--X-------B-----------o----X-Boo-----o----X--------o-----------o--o---------------o-------X--------o----v
--X-------oX------o-------X--XX-----------------o--o----B----------o-----oB---X----------------o----B---------X-X--------B-----oX-o----o---o--------------B------------o---B----oB--------oX----B---o--f
------o--------o---X---X------------o-----X------------B-XX--B-BB--------B-------------------Xo------B-------BB--------X-B--BB---------o-------X--------X--------XXB---BXo---B------o-o-X-B------------f
-B----X----X-o--X-o-----------X-----o----X---------o---oX-------X--B-------oB-------o------o----------------------B----B-oX----X-----X--o-o---------------------X--------B-------------X---o----Bo-oBB-f
-o--------X------XX---------------------------------------------o-----------------o-----X----X--Bo---o------------------------------------------o--XX---o--B--------------X------BB---BX---B-B-B------Xf
------o---X----o-----------o-----o--------------------------------X---o---------B--o-------------------o-X-------X-------------------------B------Bo---X-o-----B---B---B-----X--------o--------------X-f
---------X----------------------------B---------oo---------X--X-----------o----B---------------------Xo---BB---X----------o----B---Bo--------------------o----------X--------o-o---o---XB--o-----------f
m-X--------E--o-X--oo--o-----------B-X--X-----------------------------X------X---------E---------XX----o--oE-------------X--X-X----X-------------Xo----o-----o-o-----B-E---------o--BX----X---X----X---X
XXXXXXXXXXXXXXXXXXXXXXXXXXXXXXXXXXXXXXXXXXXXXXXXXXXXXXX--XXXXXXXXXXXXXXXXXXXXXXXXXXXXXXXXXXXXXXXXXXXXXXXXXXXXXXXXXXXXXXXXXXXXXXXXXXXXXXXXXXXXXXXXXXXXXXXXXXXXXXXXXXXXXXXXXXXXXXXXXXXXXXXXXXXXXXXXXXXXXXX
