-X----o------------X---------------------B--X-------------------B---B--B--B--X-------X---------o-------------------------B--o----X-X----------BX--oo---------B---------------------X------------o-------
-o--------------oB---X-------------X-------X--------X---B-----B------X-----o--o--oo-B----------------oXo-X---------------o--B----o----X-------X------o--------o----------o--------------------o----B----
------X------o------o-------------------o-----------------X---X--------B----X-X--X--X------oB----X-oXo------o---B----B---------X-o-X---B--o------------B-----o---o------XoX-----o--------o----------B---
----------X-----------B-------------------o-----o----------------------B--------ooo-----X----B-----X------o-----o-o--B-X------------------------B------o----------X-BXB---B-B-----------B------B--------
-------o--B--o-BX------XB----o-----X---B---------B------XB----o--X------o--------oo-----B---------o-----o-------------o------------------------o-o-----------X------XBBBBX---o-------------B------------
-----o----B--------B--B----o------o-B------B-----o----X-XXB---B----------Xo--------BX------X-------------B----X---B--B---X-------X------------B--XXBXXoX---o------o--------------B-----X--o-------------
---------B--X---X-----------X------------------------B-X------o----oX--------------o-------o----------------B--------o---B-----B----B-------------------oo--B-B----------XXX--oo----B------------o------
---Bo--B---------B-BX------B-------o-o--B-----------X--B--------------X------B----------B-----X----------B-----------o----o-BoB---B---------------o-----------o--X----------X----o--B----X--B----o-----v
--X-------o-------o-------X--XX-----B----------Bo--o----B----------------oB---X--------X--o----o----B-----------X--------BB-----X----------o--------------B---X--------o-X-BX----B--------o---------o--f
---------------o---X--oX----o-------o-----X------------B--X--B-BB--------B-----o------o------X---------------BB----------B---B-o-------X----XX----------X--------XXB---BXo---B------o-o---B------------f
-B---------X------o---B-------X-----o----X-------------oX-------XX----o-------------o------o--------B----o--------B------oX----------X--o-o---------------------X--o-----B------X------X--------Bo--BB-f
-o--------o-------------------------o---------------------------o-----------------o--B-B--X--X--BX--------X--------B--X-B--------------------B--o--XB---o--B--------------X-------B---Bo---B-B-B------Xf
----------X----o----X------------o--------------------------X-------------------B--o-------X---------BBo-Xo------X-------------------------B------Bo---X-o-----B---B---B-----X-------------B---------X-f
------B-BX-------------X--------------B---------oo------------X-----------o----B-o-------------------Xo---Bo-----------------------Bo-o------------------o----------X------o-o---------X---o----------of
m-X--------E--o-X--oo-Bo-------------X--X-----------------------------X------X--------------------X----o--oE-------------X--X-X--B-X-o-----------XX----B-----o---o---B-E---------o--BX--------o----X---X
XXXXXXXXXXXXXXXXXXXXXXXXXXXXXXXXXXXXXXXXXXXXXXXXXXXXXXX--XXXXXXXXXXXXXXXXXXXXXXXXXXXXXXXXXXXXXXXXXXXXXXXXXXXXXXXXXXXXXXXXXXXXXXXXXXXXXXXXXXXXXXXXXXXXXXXXXXXXXXXXXXXXXXXXXXXXXXXXXXXXXXXXXXXXXXXXXXXXXXX
