---o-----X--B----B-----o------o----X----------------o------------------X-X-----B---------oX----X-----------B---XX----------------------XB---X---B-B----X--XX-B-B--X-X-----------o--BBXB--o-X--XoB-----B-
-o----------B-o-----X----XX---------------B---------o------BX----X------o----B--B---o--B----o----------o-----------B-------X------o---------------XX--o-------B----X----B---oBBB-------B----B-----------
--o---X----BB-----------o----B-----------B-----B---X-----B----X--B--------B-o---X--B--------------o---oX--oo-----------o-oB---o---B----BX-----------B-----------B-----------B--oB------o-----oo---------
----o-------B---B-----------ooo-----X------B--------------BB--------B-X--X--------XB-B--Bo-Xo---oB-X-B----XBX-Boo----B----------B-------------B--o------------B-X----X-----------X-Xoo--XX---o-B-o-X----
-B------o--X--o--B-----B-oXo--BB-XB---o--XBXBB----B-----X-BX-o-----X--o---B-----------X------------------XB---------------XX-----BB-XXB---o-B-----B------oB--------B-----X-B-B---X----------o---B--o----
--X--o------o-------B---B--------X--X-----------------BBB---------oB---B---X--B---X--------B----o---B-XB-------------oX---o-o--B-oXX----o-----Bo--Xo----------------B-o----o---------X--------X-----B---
------X---Xo-X---B---B------------Bo-------o-B---------o-----B----------oB-----o----X-o-----X------------o--o-Xo--------B-------------B------X--X-------X---B--o---X-B--X-----X---X-------Bo---B--------
----o-X-X------B---o--X-------------------oB----B---X------------oo----------o-o---X------B--X----BXoB-B-XXB-o-o------B----------o---o-X---X--X-------ooB-oXX-----B-----o-----------------o---------BB-v
-------o------Bo--oBB----X-o-B-------o--X---ooooBBB-----X------B-------X--B--------B--------X----o-o------oB----------X----o-------------X----B----X---o-----------B---------o-X--------X--------BoX---f
-------XBX------B------XB---X-----B--X-----o----B--o---X----o--X-------------------Bo--B-o--B-----XX---B-X-o---B-----------------X------o-------X--oo---------B---o-----------B---o--------X-----------f
-X-BX--------X-----o-----X-------o-X------------B------X-X--------------B---ooXB-XXX-X---XX------------X--X----------o-------BB---------B--B---------o---------------o--------B---------------------o--f
--o------oXo------------oX-X-----------B------o---B--o--------B-X---B-X----------------B----B--B---X-----oB----B---o---Xoo-o-----X---X--oo-o----X-----o--------X-------------X-------B---o----X-----X-of
------B--X-X--------X--o--------------o-B-X-X-Xo----X-----BX----------X-----o-------------------X----------X------X----o-----o-X-B----BX-B----------------o-o----B--------B-------B---X----o-X------o--f
-B-----------------------B-----o------o-X-----B---------X-----o--Xo---o--X------------B-----o----B--B--X---X---o------------B-----X-oX--B-----B--oo--------oB--B-----o-o--o-----B---B-o-----Xo------X--f
m------X-Xo-BX-------B-oo-------o-o--B---XB----------B-o----XB-----o-Eo--------B-o--B-----X----X-----o----XB--X-BE---o-----X------o-----o---------------E--B------o---X-B----oBX--XE----------XB-------X
XXXXXXXXXXXXX----XXXXXXXXXXXXXXXXXXXXXXXXXXXXXXXXXXXXXXXXXXXXXXXXXXXXXXXXXXXXXXXXXXXXXXXXXXXXXXXXXXXXXXXXXXXXXXXXXXXXXXXXXXXXXXXXXXXXXXX--XXXXXXXXXXXXXXXXXXXXXXXXXX--XXXXXXXXXXXXXXXXXXXXXXXXXXXXXXXXXX
