---o--------B-B--B-----o------o----X-----------------------------------X-----------------oX----o---------------X-----------------------XB---X---B-B----X--XX-B----XBX--------------BBXB----X--X-B-----B-
-B----------Boo-----X----X--Xo------------B--------X-------------X------o----BX-B---o-------o----------B-----------B-------X------o-o-------------XX--oX------B----X----B--BoBBB-------B----B-----------
--o---X----BB-----------o------------X---B--B--B---X-----B----X---X-------B-o---X--B-----------B--o---XX--oo-----------X-oB---oX-------BX-----------B-----------XX----------B---B-------B-----o---------
----o-------B---B-----------ooo-B---X------B--------------BB-------oB-B--X--------Xo-BB-Bo-oo----B-X-B----XB--Boo----B----------B----------------o--------------X----B-----------X-Xoo--XB---o-B-o-XB---
-B------o--X--o--B-----B-oXo---B-XB----B-XBXBB----B-----X-B--o-----X--o---B-----------X------------------XB---------------XX-----BB-XXBo--o-B-----B------oB-----------o--X-B-----X----------o---B--o----
--B-oo-o----o-----------B--------X--X-----------o-----BBB------X---B-------X--B-B-X-----X-----------B-XB--------------X---o-o--B-oo-o---------Bo--Xo----------------B-o----o--------oX--------------B---
-X----X---Xo-X---B---o------------Bo-------o-B---------o-----B-------X--oB----------X-o-----X------------o--o-Xo--------B-------------B------X--X-X------------X---X-B--XX----X---X-------Bo---B--------
------X-X------B---o--X-------------------oB----B---X------------oo----------o-o---X------B--X-----XXB-B-XXB---o-X----B----------o---o--o--X--X-------o-B-oXX-o---B-----o-X---------X-----o---------BB-v
--------------B--ooBB----o---B----X--o--XB-B-oooBB-------------B-------X--B--X-----B---o----X----oXo------oB----------X----o-----------oBX----B----X---o-----------B---B-----o-X-----------------BoX---f
-------XBX------B-----------------B--B-----o----B--o--------o--X-------------------Bo--B-o--B-----X----B-o-o---B--------B--B-----X------o-------Xo-oo---------B---X-----------B---o-X------X-------B---f
-X--X--------X-----o-----X-------o-X------------X------X-X---------o--------o-XB-X-X-X---X---------o---X--X----------------X-BB---------B--B----X-B--o---------------o--------B---------------------o--f
-Xo---B--oXoB-----------oX-X-----------B------oo--B--o--------B-X---B-X----------------B----B--B---B-----oB----B---o---Xo--o-----o---X---o-o----X-----o--------X-------------X-------B---o----------X-of
------B--X-X--------XX------X---------o-B-X-X--o----X-----BX----------X-----o-------------------X----------o------X----o-----o-X-B----BX-B------------------o----B--------B-------B---X----o-X------o--f
-B--------------------o--B-X---o------o-X----XB---------X-----o--Xo------Xo-----------------------B--X-X---X---o------------B-----X-oXB----X--B--oo---------B--B-------o--o-----B---B-o-----Bo------X--f
m------X-Xo-BX-------B-Bo-----X-o-oX-----oB-----X----B-X----XB-----o-Eo--------B-o--B--B--X----X-----o----XB-BX-BE---X-----X------o-----o---------------E-BB------o---X-B----oB---XE----X-----XX------XX
XXXXXXXXXXXXX----XXXXXXXXXXXXXXXXXXXXXXXXXXXXXXXXXXXXXXXXXXXXXXXXXXXXXXXXXXXXXXXXXXXXXXXXXXXXXXXXXXXXXXXXXXXXXXXXXXXXXXXXXXXXXXXXXXXXXXX--XXXXXXXXXXXXXXXXXXXXXXXXXX--XXXXXXXXXXXXXXXXXXXXXXXXXXXXXXXXXX
