-o----o----------B-X--------------------------------------------B------BX----Xo------X-----X-o-X---------------------B---B--o------X-----X----BX--oo---------B---------------------X------------o-------
-o--------B-----o----o---B------X--X-------X---B--------B----oB------X-----o--o--oo-B------X---------oXo-X-----------o-X-oB------o----X-------X----------X----o----------o-------------B------o---------
------X-------------oo-------------X----o---------------------X--------B----X----Bo-X-------B------oXo------ooB------B-B-------X-o-X---o--o-------B----------o---o----o-XoX-----o--------o----------B---
--X-------X-----------B-------------------o-----o----o--------------o--X--------ooo-----X----B-----X-oB---o------------X------------------------B-----------------X-BX----B-B-----------B------B----o---
-------o--B--o--X------XB----o-----X------X------B------XB----oo-X----B----------Xo-----B---------o-----o-----X-o-----o-X------------------------o-----------X-o----XBBBBB---o--------------------------
-----o----B------X-B--B----o------o--------B-----o----X-XXB---B----------X----------X------------------B-B----X----------X--------------------B--XXBXXBXX--o------oB-----------o-B--o--X----------------
------o-----X---X-----------X----------o-------B-------X------o----oX------------o---------X--------------BXB------X-B---X-----B--B-B------B---------X---o--B-BX---------XXX--oo-----------------o------
----X--B---------B-BX------B------------B-----------X--B--------------X-o----B----------B-----X--------o-B----------------X-BoX-------------------o--X--------o--X---o------B----o-------X-------------v
--X-------o-------o-------X--XX-----B-X---------o--o----B----------------oB---X--------X---X---o----B------X----X----Xo--B------X-----X--o-o-o------------B----B-------o---B-----B--------o----o----o--f
---------------o---X---X------------o-----X------------B--X--B-BB---X----BX------------------X------------o--BB----------B--XB-o-------o-----------o---BX--------XXB---BXo---B------o-o---B------------f
-B---------X-----oo-----------X-----o----X---X---------BX-------X-------------------o-----------------------------B------oX----------X--o-oX------------B-------X--------B-------------X--------Bo--BB-f
-o--------X------------o----------------------------------------o-----------------o----B-----X--BX-------------------oX-------------------------o-oXX---o--B--------------X-------B---BX---B-B-B------Xf
------o---X----o-B---------------o----------------------X-----------------------B--o-------o------X------X-------X----------------o--------B------BX---X-o---------B---BX----X-------------B---------X-f
---------X-------------B-X-B----o-----B---------oo------------X-o---------o----BB--------------------XoX--BX-----------------------Bo------------------B-o----------X--------B-o-------X---o-----o---o-f
m-X--------E--o-X--oo--o---------o---XX-X--------------------B--------X------X--------------------X-------oE-------o-----X--X-X----X-------X-----XX----o-----o-------B-E---------o--BX-X----o-oo---X---X
XXXXXXXXXXXXXXXXXXXXXXXXXXXXXXXXXXXXXXXXXXXXXXXXXXXXXXX--XXXXXXXXXXXXXXXXXXXXXXXXXXXXXXXXXXXXXXXXXXXXXXXXXXXXXXXXXXXXXXXXXXXXXXXXXXXXXXXXXXXXXXXXXXXXXXXXXXXXXXXXXXXXXXXXXXXXXXXXXXXXXXXXXXXXXXXXXXXXXXX
