---o-----Xo-B-----------------o----B---------B-------------------------X-X----------------X-------B------------o-----------------------oX---X---B-B--X-X--XX---B-XX-X-------------B--XB---XX--X-B---B-B-
-BB--o------B-o---------------------------B----------------------X----BXo-------B---o-------o----------B-------------------X-X----o----------o----XX--o------------X---oo---oBB---BX--------B---------o-
--o---X----BX----------X--------X--------B---------B-X---B----------------B-o-o-X--B--------------o---oX--oo---Xo------o-oB---o--------B------------B------o---BX-----------B---Bo----X-B---------------
--o-o-------B---X----X-----Boo------X--BX-BB------Bo------oB--------B-X--X--------XBXB--Bo-oo-X--B-X-B----oB----o---XB--B-------B---------------Bo-B-----------Xo----X------B--BBX-Xoo--XB-----B-o------
-B------o--X-----B-----B-oXo---B--B------XBXBX-------BX-X-B--ooo---X--------o--B------X------------------oB-----B--------XXo-----BB-XXB-----B-----B------oX----------X---X-B---B-X----------o--oX--o----
-XB--o------o-----------B--------X--X-----------------BX---B-------o-------X--B----------------o----B-XB--------------X-----o--B-o---o-----Xo-Xo-oBo-------------oB-B-o--------------B----------X--oB---
-----XX---Xo-----BX--o------------Bo-------o----------oo-------------X--oB--X--o----X-o-----B---o-X------o--o---B-------B-------B-----B---o--X--X--------------X---XB-B-B---------B-------Bo---BX-------
------B------------o-oo-------------------oB--------X------------oo----------o-oX--X--B------X-----X---B-X-X---o------B----B----Xo---o----XX-B-----X--o-B-ooX-----B---B---------------------X--o----BB-v
---------B----B----oB-----o-----B--B-o-o-----ooo-B-X---------------------X---------B-------------B-o------oB---o--X--------o---------X---X----B----X---Xo----------BB-B------ooXo-------B--------Bo----f
-------XBB------B----B------------B--X-----oB---B-Xo--X-----X--X-------X-----------Bo--B-o--B-----XX-X-B-o-oB--------------------------oo----------oo---------B---X----B----------o--------X-o--B-----Bf
-X---o----B--------o-----X-------o-X------------BoB-------------------------o-XBoXoX-X---X-------X-----X--X----o--------------B---------B--B----o----o--------o--------B------B------------------------f
--o------oX--------o----oB--X-----------------o-X----o--------X-X---B-XB---X-----------B----B--B-o---X----B--------o---XX--o--X--X-B-----o-o---BX--------------X------------o-------BB---o----------X-of
------Bo-X-X--------X------------o--B-B-BoX----o----X-----BX----------X-----o---X---------------X----------o---Bo-X----o-----o-X------B--B----------Xo------B----B--------B---------------BXBX------o--f
-X--o---o----B----------BB------------o-X-----B----o----X-----X--Xo------X------------Xo----B--------X-X---X--X---X-B-------B-------oX--------B---o---------B--B-------o--o-----B-----o---X-oo------X--f
mB-----X-XB-B--------B-Bo-------o-o------oB---X-X----B------XB-----o-Eo--------B-o--------X----X-----o---oXB--X-BE---X-----XX--o--o--o-BooX--o--------o-E--BB-----o---X-X----oB---XE-----------B-XXo---X
XXXXXXXXXXXXX----XXXXXXXXXXXXXXXXXXXXXXXXXXXXXXXXXXXXXXXXXXXXXXXXXXXXXXXXXXXXXXXXXXXXXXXXXXXXXXXXXXXXXXXXXXXXXXXXXXXXXXXXXXXXXXXXXXXXXXX--XXXXXXXXXXXXXXXXXXXXXXXXXX--XXXXXXXXXXXXXXXXXXXXXXXXXXXXXXXXXX
