-XX---B--------o---X-----X----------------------------o----o-X--B------B-----X-----X-X----X----o-------------------------B--o----X-X----------BX--oX---------B---------------------X------------o-------
-o--------------oB---o---X-----o---X-------X------------B---B-B------X-----o--oX-oo-B----------------oXo-X-B-------------o---B---o----X-------X------o--------o----------o--------------------o----B----
------X-------B-----o-------------------o------X--------------XX-------B----X----B---------XB------oXo------oo-----------------X-o-X---o--o-----X------------o---o------XoXXX---o--------o----------B---
----------X-------B--BB-------------------o----Xo----------------------B--------ooo-----X----B-----X------o-------B--B-X------------------------B-------X---------X--XB---B-B---------X-B------B--------
-------o--B--o--X--o---XB--B-o-----X-------------B------X-----o--X---------------oo-----B--X------o-----o---B---------o--------------------------------------X------XBB-BX---o-o------------------------
-----o----B--------o--B----o------o--------B-B---o----X-XXB---B-------o--X----------X------XB------------B----X------B---X-------------------oB---XBXXBX---o------o--------------B-----X----------------
------X-----X--BX-----------X--------------------------X------o----oX---o-----------o------o----------------B------------X-----B----B------------X-------o--B-B----------XXX--oo-----------------o------
----o--B-------o---BX------B-------B----B-----------X--Bo---------X---X------B----------o-----X----------BB----------o----X-BoB-------------------o-----------o--X---------------o-------X-------o-----v
--X-------o-------o-------X--XX-----B-----------o--oB---BX---------------XB---X--X-----X-------o--X-B----B---B--X--------B------X----------o--------B-----B------------o---B-----B--------o--B------o--f
---------------o---X---o------------o-----X------------B--X--B-BB--------B-------------------X---------------BB----o-----B--BB-o-------o------o--o------X---------XBX--BXo---B------o-o---B--------B---f
-B------X--X--o---o-----------X--o--o----X-------------oX-------X---------------Xo--o------o----------------------B------oX----------X--o-o------------------X--X--------B-B-----------X----BB--Bo--BBBf
-o--------X----------------------------------X------------------o-------o-------X-o----B-----X--BX----------X-----------------------------------o--XX---o--B--------------X-X-----B---BX---B-B-B------Xf
------o---X----o-----o-----------o-------------oB---------------------o---------B--o-------------------o-X-------X------------------------BB-----XBo---X-o-----B---B---B-----X-------------B---------X-f
---------X----------------------------B----B----oo------------X-----------o----B------------B-B------Xoo--Bo-----------------------Bo------------X-------o---------XX--------o-o-------X---o-----------f
m-X-X------E--o-X--oo--o-------------X--X---------------------------XXX------X---------X----------B----o--oE------o------X--X-X----X--------X-----X----o-----o-------B-E---------o--BX--------o----X---X
XXXXXXXXXXXXXXXXXXXXXXXXXXXXXXXXXXXXXXXXXXXXXXXXXXXXXXX--XXXXXXXXXXXXXXXXXXXXXXXXXXXXXXXXXXXXXXXXXXXXXXXXXXXXXXXXXXXXXXXXXXXXXXXXXXXXXXXXXXXXXXXXXXXXXXXXXXXXXXXXXXXXXXXXXXXXXXXXXXXXXXXXXXXXXXXXXXXXXXX
