-B----o---------------------B-----------------oB----X-----------B------B-------------o------o--o-------------------------XB-o----X-B---------XBX-ooo---------B-------o--------------------------o-------
-o---------------B---o-------------X-------X------------B---------------o--o--------B----------------oX--X-X-X---o----o----------o-----X----B-X---o-----------o-----X----o--------------------o--BB-----
------X-----------------B-o------------X----------------B-----XB-------o----X----B---------XB------o-X------o------------------X-o-----o--------------o-----------X---B-BoX-----o---o----o--------------
--------------BX------o-------------------o-----o--------------o----X-----------o-o----XX----B----B-------o----------B-X-------------------------------XB----B----X-oXo-----B-----------B------B--------
-------o---X----B--B---X------B----X----B------X-oB-----XB-------X---B------------o-----B---------o-----B-----B--X-------X---------------------o-oB-----------------XXBBB----B--X------o----o-----------
-----o-----o----------B----o-------------X-B-----oX---X-------Bo---------X----o-o---o------o---B-X-------B-----------B--o---------------------B--XXBXXBX---B------o------B-------B-----X-B--------------
------X-----o-o-X----------B----------------X------------------------------------------X---o----o---------X-X-------------------o----------------B-------o--B-------------X----o-Xo--------------o------
----o--B---X--Bo---B--B----o------------BB-----X-------B--------------X--o-------------------------------------------o---BX-BXB----oB--------B----o-----------o------------------------B-o-------------v
--X---------------o----------X------B-----------o-Xo-------------o---X---oB-----------X-----------------o-------Bo------o---------------------------------B-------B--o--------------------o-------o-o--f
--X----------------X---X---------------o---X-------------------BB--------B-X-------------X--BX---oo---------------o------------o-------o--------B----------------XXB---B-o---B------o-o---B-----------Xf
-----------X--------------o--XX-----o-----------B-B----BX-------o---------B--------------------------------o---B----------X-----------B--Bo------X-------o---------------B-------------Bo-----------B--f
----------------------------o-----------------------------------o----B-o-------B--o--B-B--------B----------------------------X-o-------------------XX---o-------------o---------------B-X-BB-B-B-X-----f
-----oo---B----X-----------------X-B-------o----------------B-X-----------------o--o---o-Xo---------o----X-------X---B---------------------B------BB---X-------Bo--o--XB-----o-------------B-----------f
--------------------------------------B----------o------------X----------Xo---oo-------------------------XB--------------B----------o------------------X-----------------------o-----o-X---o-----------f
m------B-oBE--oB-oXoo--o-B-----------X--X-----o----o-------------B--X-X------XE----------X--------X----o--oE--------o--B------X----------------BoX-----------o-XB----B-E-------o-----X--------B----X---X
XXXXXXXXXXXXXXXXXXXXXXXXXXXXXXXXXXXXXXXXXXXXXXXXXXXXXXX--XXXXXXXXXXXXXXXXXXXXXXXXXXXXXXXXXXXXXXXXXXXXXXXXXXXXXXXXXXXXXXXXXXXXXXXXXXXXXXXXXXXXXXXXXXXXXXXXXXXXXXXXXXXXXXXXXXXXXXXXXXXXXXXXXXXXXXXXXXXXXXX
