---o-----X--B-----------------o----B-------------------------B----oX-----------------------------------B---X---------------------------oB---o---B-X----X--XX-B-BX-X-X----------------XB--B-X-oX-BB----B-
-B----------Boo----------------B----------BB-o----------o--------X------o---BB--B---o-------o----------B------B-------X----X------o-------o-------XB--o------------X----B--BoBB-------------B-----------
--o---o----B-------o---------X-----------B-BX------X-B-B-B-----BX---------B-o---X--B--------------o---oX--oo-B------B--o-oB---o-----B-BBo----------BB-----X-----X-----------B---B----X-------oB--o------
----o----o--B---B-----------ooo-----X---X--B--------------oB--------B-X--X---o--B-XB-B--BoBoo----B-X-B----o----oo----Bo--------oB----X-----------o-----B-o------X----X--X--------X-Xoo--XB-----B-o------
-B-B--o-o--X-oB--B-----o-oXo--XB-XX------X-XBX----------X-B-Bo-----X------------------X----------o-------oB---------Bo--XXX----X-BB-XXB-----o-----B-------B--B-----------X-------X-o------o-o---X--o----
--B--o--B---o---oXB-----B------o-X--X-o--------------XBX-B---------B-------X--B-Xo-------o---X------B-XB--------------X----XoB-B-o-------------o--oo---X----------X-B-o----X---------oB-------------B---
----o-X---XX-----o---X--------X---Bo-------o-----------o----------o--X--oB-o-----B--X-o-B--XB------------o--o--o-----o--B-------------B--B---X--X--------------X---X----B---------X-------Boo--B--------
---X--B------------o-oX-----------B-------oB--------X---X--------oo---------oo-o---X---------X--X-oo-o-B-X-B---B-B----B----------o---o-X--BX----------o-BoooX-----B--------B---X-o--------o--------BBB-v
--------------B----BBo---------X----oo-X-----oXo-B--------B--X-o-------X-----------B---------------o------oBX--------------o-------------X----B--X-X---X----------BB-------B-ooX------------B----Bo----f
-------XBB------B-----B----------B---X---B-oB--oB--o--------o-X-----oB-------------Bo--B-o-oB-----XX---B-o-o---B-X--X-------------------oo---B-----oX---------B---X---------------o--------X-o-----oo--f
-X-o---------------o-----X-------o-X--X---------B------X---------------X-B--o-XB-X---X---B------------XX-XX-------------------BX--------B--B-o-------o---X----X-B---X------B--B-----X--------------X---f
--o-X----oX-------------oX-X------------B-----o--BB--oX-------B-X---B-X------B---------B----B--o---X--o-o-BB---B---o---XXB-o-X---X-------o-o--X-X--------B-----X---------------XB---BB---o-----X----X-of
------B--X-X--------X-------------B-----B-X----o--X-X-----BX----o-----X-----o--------------o---BX----o-----o------X----X-----o-X------B--B-X-------o--------o----B--------B-----------X--B-X-X----X-o--f
-X-----------B-----------B------------o-X----XB-----o---XX----Xo-Xo------X-------X------o----X-------X-X---X---o--------XX-BB-----B-oX--------B---o---o-----B-o--------o--o-----B-B---o-----Bo------X--f
m------X-Xo-B--------B-Bo-------o-o------o------X----B------XBX----o-Eo--------B-o--------X----B-----o----XB--X-BE---X-----X------o-X---o------------o--E--B------o---XBX--B-oB---XE--X-X------B-------X
XXXXXXXXXXXXX----XXXXXXXXXXXXXXXXXXXXXXXXXXXXXXXXXXXXXXXXXXXXXXXXXXXXXXXXXXXXXXXXXXXXXXXXXXXXXXXXXXXXXXXXXXXXXXXXXXXXXXXXXXXXXXXXXXXXXXX--XXXXXXXXXXXXXXXXXXXXXXXXXX--XXXXXXXXXXXXXXXXXXXXXXXXXXXXXXXXXX
