---o-----o--B---oBo--X-o------o----X-----------------------------------X-------o---------oB--------------------X--------------------B--XB---X---B-B----X--XX-B-B--X-X--------------BBXB----X--X-B-----B-
-B----------B-o-----X----X----------B-----B-----B-------------o--X------o----B--B---o-------o----------B-----------B-------X------o---------------XX--o-------B----XB---B---oBBB-------B---oB----B------
--o---Xo---BB----o-----------------B-----B-----B---X-----B----X---------BBX-o---X-XB------X-------o---oX--oo-------B---o--B---o------B-BX-----------B-----------X-----------B---B-------------o---------
----o-------B---B---o-------ooo-----X------B--------------BB-----B--B-X--X--------Xo-B--oo-ooX---B-X-B----XB--Boo----B----------B----------------o--------------X----B-----------X-Xooo-XX---o-B-o-Xo---
-B------X--X--o-XB-----B-oXo---B-XB------XBXBB----B-----X-B--X-----X--o---B-----------X------o-----------XB---------------XX-----BB-XXB---o-B-----B---B--oBo-------------X-B-----o----------o---B--o-X--
--B--o------o-----------X--------X--X-----------------BBB----------B---X---X--B---X-----------------B-XB-------------oX---o-o--B-oX-----------Bo--Xo----------------B-o----o------------------------B---
------X---Xo-X---B---o------------Bo-------o-B---------o-----B-------X--oB----------X-o-----X------B-----o--o-Xo--------B-----o-------B------X--X--------------X---X-B--X-----X---X-------Bo---B--------
------X-X------B--Xo--X-X-----------------oB----B---X------------oo----------o-o---B------B--X-----XXB-B-XXB---o------B----------o---o-----X-X--------o-B-oXX-----B-----o-----------------o---------BB-v
--------------B---oBB----o---B-------o--X----o-oBB-------------B-------X-------o---B--------X---oo-o------oB----------X----o-------------X----B----o---o-----------B---------o-X-------X---------BoB--Bf
-------XBX----B-B------o----------B--X-----o----B--o--X-----o-BX-------------------Bo--B-o--B-----XX---B-o-o---B-----------------XX-----o-------X--oo---------B---X-----X-----B--Bo--------X-----------f
-X--X--------Xo----o-----X-------o-X------------B--X---X-X-----------------Bo-XB-X-X-X---B-------------B--X------------------BB---------B--B---------o---X-----------o--------B---------------------o--f
--o------oXo------------oX-X-----------B------o---B--o--------B-X---B-X--------------o-B---oB------X----XoB----B---o---Xo--o-----X---X---o-o----X-o---o--------X-------------X-------B---o----o-----X-of
------B--X-XX-------X-----o-------X---o-B-X-X--o----X-----BX----------Xo----o------------------XX---------Xo---o--X----o--o--o-X-B----BX-B------------------o----B--------B-------B---X-------------o--f
-B------X----------------B-B---o------o-X-----B-----o---X-----o--Xo------X------B----o-B-------------X-X---X---o------------B-----X-oX--------B--oo---------B--B-------o--o-----B-----o-----Xoo-----X--f
m------X-Xo-BX-------B-Bo-------o-o------oB-----X----B------XB-----o-Eo---o----B-o--B---X-X--B-X-----o----XB--X-BE---X-----X------o-----o-B--------o----E--o------o---X-B----oB---XE----------XB-------X
XXXXXXXXXXXXX----XXXXXXXXXXXXXXXXXXXXXXXXXXXXXXXXXXXXXXXXXXXXXXXXXXXXXXXXXXXXXXXXXXXXXXXXXXXXXXXXXXXXXXXXXXXXXXXXXXXXXXXXXXXXXXXXXXXXXXX--XXXXXXXXXXXXXXXXXXXXXXXXXX--XXXXXXXXXXXXXXXXXXXXXXXXXXXXXXXXXX
