-o------BB------------------B-X----------o--------------B-------X----B----------------X-----------------XB--------------X-B-----X-B------X------B-------------B--X---X-------X--o-------X------------X--
-B-o-----X--------------------------------B------X------------------------o--o---XB-----o---B----B----------B---------o-----o-----------------o---B-------X------------o-----------------------------o--
---o-B----B---X---------B----------B-B-------------------------------o-------o---------BX-B-X--------------o------B------B-------------o-----B---------B------------------------X----------o---X-----XB-
----X-----o-X---------X--------B--X------------------------------------------------------B-----------B------X-X----------------------------o------------------o-X---B-X---X---------------o-----oB----X-
---o---X-B---B--B-oXX--------------------X--BX-----XBBo----B------o-----X---------B---------X--B-----------B-o-----X--BXo------------B----B----------------X-----o----------------------X-X-------------
------------X---------------------------B------------------------------B------X-------o-----------X-----X---------o----------------o-oB---------XB--------------------oo-o------X--X---------------X-o--
-------------------------------------B----o-------------------------------o--o-----------------X------------B------o--------------Xo---X------B--------o---------------X----------B-o-----B--X----X-----
-----------X-X-o--------------------B------X-----o------B------XX--------------------X-------o-----B--------o-------------X-----B--BB---o-----X-------o-X-o---------------X-------------------oo-------v
----B---o-------------------o--------o-----------------B--BX------X-----------X------------------oX---B---X-------------------------------X--X----------------B------------------------X------o-----o--f
------oX--o--------X-------------B------B------------------o--------X------------B--------------o--------o----------X------------------------X--X------B---B-------------BXXX-----B-B-o----B-----------f
---------------Xo--o-----------o-------X---------X---------X----------B------Bo------B--o------------------o-------X------------------------X----B--X-----------------------------B-----X-B-B---------Bf
-----X-----o--------X---o-o----------B----o-----B-------------------------o---------o-------------BX--X---B----------------B--X-----B----------------------------B----------B------B-------------------f
----------------------B----X-------------oB-----B-o-------------X-----X--------------o----------------------XXXXBB--------oX-------o--B---oo----------B--------X-----------------X---------------X-oo--f
mXXXXXXXXXXXXXXXXXXXXXXXXXXXXXXXXXXXXXXXXXXXXXXXXXXXXXXXXXXXXXXXXXXXXXXXXXXXXXXXXXXXXXXXXXXXXXXXXXXXXXXXXXXXXXXXXXXXXXXXXXXXXXXXXXXXXXXXXXXXXXXXXXXXXXXXXXXXXXXXXXXXXXXXXXXXXXXXXXXXXXXXXXXXXXXXXXXXXXXf
XXXXXXXXXXXXXXXXXXXXXXXXXXXXXXXXXXXXXXXXXXXXXXXXXXXXXXXXXXXXXXXXXXXXXXXXXXXXXXXXXXXXXXXXXXXXXXXXXXXXXXXXXXXXXXXXXXXXXXXXXXXXXXXXXXXXXXXXXXXXXXXXXXXXXXXXXXXXXXXXXXXXXXXXXXXXXXXXXXXXXXXXXXXXXXXXXXXXXXXX
XXXXXXXXXXXXXXXXXXXXXXXXXXXXXXXXXXXXXXXXXXXXXXXXXXXXXXXXXXXXXXXXXXXXXXXXXXXXXXXXXXXXXXXXXXXXXXXXXXXXXXXXXXXXXXXXXXXXXXXXXXXXXXXXXXXXXXXXXXXXXXXXXXXXXXXXXXXXXXXXXXXXXXXXXXXXXXXXXXXXXXXXXXXXXXXXXXXXXXXX
