---o-----X--BB-----o---X----o-o---------------------X---B--o--o-o-----------------B---B----o-B-----o-----X-B-------o---------X---------oBB------B-oo-------B-B-B--X-----o-------------B----X----B-------
-B----------B-o--------oB-------------B-------------------------XXo------------BB---o-------o----X-----B----------B--------X------o--o-----------o-X---X--X-----B--X----Bo--o-B---B-o---X---B-----o-----
--Boo-X----B-----o------X--X------B-X--------X----------oB----------------B-oXX-X---BB-B-B-X-----X----oX--B------B-----o-oB------XX----B-----------oB-------------X-----Bo--B---BX----------------------
----o-------B---B------------oo------------B-----------B--X--B--o---B-X-oX--------Bo-B--Bo--o----B-X-----o-B--------------------X-----B------XoB-o----o-X------------X---o-------X-XBo---B----BB-o-o----
-B------BB-X-----B-----B--Xo---B-XB-----BXBXBX---------BX-B--o-----Xo-------X---------X-o---oX-------o---oBB-o-------X-----------B--XXB--o--B-----B------oB--X--X------B-X-B---o--oo------B-----X--o----
--B--o-----Bo-o---------B--------X-B--------------X----XX----------B----B-----B---------o-----------B-X-X------------oX-----o----B--------o---Xo---o------------B---BBo--------------X-------------oB---
-----oX---Xo-----B-------o---B----BB-------o--o--------o------o------X-XBB-------X--X-o---X-B------------o--B--o--------B------------BB------X------------o----XX-------Bo----o--Xo--------o---B--------
------B---B--X-----o-o----X---------XX-X--oB----o---X------------X---o-----X-oBo----B--o-----X---B-----B-X-BB--o------B------X---o-X-o-----o---X--B---o-B-oBX-----B-X---X------BB--------Xo---X-----BB-v
-B----------B-B-X--oBX-------B------------B-Xo-o-B--B-o----------------X----X------B-------------X-o---B--oBX--------------o--------------o---oX---B----B-B-----B--B---------ooX---B--------o----B--B--f
-------X-X---B--X--------o--------B----B---oX---B--oo-----B-o--X---------X-----B---BB--B-o--X-----XX---o-oX----B--X--X---------o-----oo------------oo-----o---B-o-X---B------o-XX-o--------X-o-X-------f
-X--X-------------Xo-o---XBB----------------B---o---------------------------o-XB-X---X---o---------o---B--------------------X-o--Xo----------------X-o------------X-B----X-o--BB--X----o----o-B--------f
--------------X----X-------X-o---B----X------oo---BB-o-----o--B-X-----X-----------X----Bo---BX-B---X------B-o---o--Bo--X---o--X--X-----o-o-o----X------------XB----B-----o------o---BBo--o----------X-of
--X---B--X---o-o----X---------------------B----o----X-----B---------B-X-----o-------------------XX---------o----o-X----o-----X-BX--------B---------B---o----o---XB-o----o-B--------o--Xo---X-X-X---Xo--f
-X----o--------B------B--B----------o---X-----B---------B-----X--XB----o-X--X--------------------oo----X---X---B-o----------B-X-o---oX-------X---Xo-B-------B------oo--o--------X-----X-----Xo--o---X-of
m------X-Xo------------B--X-----o-----XoXoB-----X---XB-o---oXB---B-o-Eo--------B-o--------X----------o----XB--X-BE---X-X--XX----------XBo---------------E--B-X----oX--X-X----oB---XE-B-------B------o--X
XXXXXXXXXXXXX----XXXXXXXXXXXXXXXXXXXXXXXXXXXXXXXXXXXXXXXXXXXXXXXXXXXXXXXXXXXXXXXXXXXXXXXXXXXXXXXXXXXXXXXXXXXXXXXXXXXXXXXXXXXXXXXXXXXXXXX--XXXXXXXXXXXXXXXXXXXXXXXXXX--XXXXXXXXXXXXXXXXXXXXXXXXXXXXXXXXXX
