---o-----X-B---------------o--o--------Xo-B--X----------------B-----------o-------X---------------------------o--B--X------------B------B----X--B-B-----B--X-B-BB-X-B-----------------BBBo-X----B--X-X--
-B----------X-B------Bo-------o--B----------------X--------------X-----------o--BX--o--B----o----------B----------------X--X--B-ooo---------------Xo------B---B------------oo-X------X------B-----------
--o---X----B-------B---X---------------oB------------------B--------------B-o---X--------B-o----------oX-----------X---o-oB------------X-----------------------BX----B------BB--B----XB-X----------X--o-
----o--B--------B------------oo------------B---------------------BX-B---oX--------XB-B--BX--X--o-B-o------------Xo--X-------X---B-----B----------o----o-X--B----X--X-X-X---------X-Xoo-oBB----BB-o------
-B------B--X-----B--------Xoo--X-oB---X-oXBXBX----o-X---X-B--o-----X--oX-----X--B-----XBoX---------------o-----B------------B--o-BB-oXB-----B----BB------oB-----oB-------XoX------------o--B---BX--o----
--B--o----BBo-----------B-----X--X------oo-Xo-B-----o-oX-----------B----------BB-----o--------------B-X----o----------X-----o-oB-o-----o-X-----o-B-o-X---------o---XB-X------X-------o-----------B--B---
-X--X--B--XoX----B-oB----o--------Bo-------o---------X-o-------------X-o-B--X-------X-o-B-o-B-----B--X---o--o--o--------B--X-XB------XB------X-B------o-B---B--X------X-B---o-----X--------o--XB--------
------B------------o-------B--X-----o-----oB--------X--------X---o---X-------o-o--BX--------XX-o-------BXXBB-X-o------B----------o-XoX----oo-o-----B------ooXo----B---------------X-------oB--------BB-v
-----------B--B---o-B-------------------o----o-o-B-----X--------------BX---X-------B-----o---------X-o-------o-------------o----oX-----o------B----X----B---------Xo---------ooX-----------------B-----f
-------XBX------B-----------------BX----B--X----B--o--------o--X--B----------------Bo--B-o-XB-----BX--oBXo-X--Bo-----------------B-----oXB--o--o---oo---o---o-B---X------------B--o--------X-o--B--o---f
-X-----------------o-----X-------B----o---------B------X------------o-----Xoo-XB-X--BX--------------oX-X-Bo-o------------o--o-----------oo-----o-----X--X----------B-o--------BB--------------o------B-f
-----X----X-----o------o---X------------o----Xo------o--------B-X-X---X---------o------X----BB-BB--o----X----------o--oX--XB----BXB---o--ooo-o--B-B-----B-----------------X---------BB---oo---------X-of
---------X-----X----X------------------BX-X----o----X---B-B--o--------X-----oX------------------XX----------------X----o--B--oXX---------B----X-------------o----o--oB----B-----------X--XoX-X------o--f
-X-o---B--o---o----------B--B--o--o---o-------B---X-----B-----X--Xo---B--X------B----------------------X---X-X----XB------B-B-------oX-----o------o-o-------B------o---o----o---X--X--------Xo------X-Xf
m------X-XoXXB-o------oB---X----X-B-----BoB-----X----B------XB-----o-Eo--------B----B---o-X----X-----o-B--o---X-BE---Xo---oX--------X--oX---------------X--BX-----o---X-X-----B---XE-----------B-------X
XXXXXXXXXXXXX----XXXXXXXXXXXXXXXXXXXXXXXXXXXXXXXXXXXXXXXXXXXXXXXXXXXXXXXXXXXXXXXXXXXXXXXXXXXXXXXXXXXXXXXXXXXXXXXXXXXXXXXXXXXXXXXXXXXXXXX--XXXXXXXXXXXXXXXXXXXXXXXXXX--XXXXXXXXXXXXXXXXXXXXXXXXXXXXXXXXXX
