-o----B------oo-o--B--o---o--o--oBoB---o--------B-------o----B-X--Xo------X-------------B-B---o---X------o------oB---------B-----------X-o-o-X---B-B--o-B-o--------X---o------X------o---X--X------B-oo-
----o------X-BB-X----------o-o-----oX--B---------------------o---X--oooo-X-X-o-o---X---X----B----BooB-o----o--o--B--X-----BBo--o----o----------------o---oBB----X---X--XB--B---o-------------------X----
-----o----X---o--X---X----XB---oX---------BBB--o-X---o-----X-B----B----o-----o--Xo-------X------B-B--X---o----XB-------o---X-----X-----X----X--------B----Xo----------------------X-o-X-o----------o--o-
-------------Bo--------X--X-X--B----o----------B-----BXBBXB------o--------X-----ooo----XBX-XB---o-X----o--------B--B--BBBo--BX---B--o--------o-oX-B-----X-o----o------o---X----XB------B--BB---------B--
----o------X----o----XBBo-BBo----XooX---Xo-X-BB-B-X-o--X------XX-oo-------------o-oo--BB---B-----B-----------------X----------oX-o----X---B-B-----B---------B-BXX-o------B-XX--------------B---o--------
-----------B-B--------oXo----XX---o---oB-----X--X-o----B--XB-----XXo--X-X--o-X---o-----B------X-BX---o--o-----X-oX---X-------BX-X--XXoXBBX-B--------------o-o--BBXBXBXXBX---------o---X--------o---Xo---
---------------XB-----o---o--B------------B--o--X---X-------B----o---------B--oB---o--o-X--o-B--X-------BX-BB----------X--------B----------o----oB-------B----B-------oX-o--X-X-----o----o---XBo------B-
----B---------X---B--B-o---BXBXX-------------X-B-----XX--o---o-B-ooB-B----oX-----o---oB---B---X----BX-----BB--BXoBX-oB---B-B--oo---------X-------o-B--Xo-X--ooX-o----o-o-----o-----X--------Xo-oXX-----v
-B-X--XXB--X-o-X-X---o----X--B-B---BX---o-----oB----B-o-o----o------X-----X-X--------------o-----oXX----oB--X---X------o-----BBX-XBX-XB----o-----B--X---BX----Boo-o-X---Xo-BX-------oo-oo-XB-----------f
--------------------oX-----o----o---o---B-X---BXXB-X------X-----o--X--X---B----o-o--o-------B----X--o--B---X--o--XXB--------oBB---------B--o-B--o---o--o---ooXX-oB--X------B----X-B-Bo------o---o------f
----------X-o--X----------B---B---X----o-oX-----XX-X----------o-----o-----X-------------o-----o--------B-B----o---oB--B------------o----B------X-o--------o-----------o--oBB-X--XX-B----XX---------X-o-f
--B-BX-----oo--B-X-o-o--o---BB--B---o-------X-B-oX-X---------B--------X-X--X----B------------o-oX-------X---B------X--X-------X-X--Bo----B-o---B-X-XBX----o-o-------B----------o--------B--------------f
--B--X-B-X-XB------o------B---o----o-----------o----o------o------B-BX--o--X------B-B------o-X---o-XB------B--B---------B---B--------------Xo----B------B------oX----X----oB--oBo------------B------X-of
-o--X--B---X-X-------X------X--o---X-----------BBo---------X------o--oX-X----X--X----o---------o-B---BBB----------B-o---o-B------o---BoX---o--X----o---B-BB------B-------oX---------B-----B--Xoo-------f
mX--------------------X-B-X----X-B--o--XBBo---X------X-------XBo---o-X-----XBX--oX----o-o--X-XoB--o-----------------oB-BE--------o---BB-X------oE-o-Eo--X--o-----------EX-o----------XBo------XX---X---X
XXXXXXXXXXXXXXXXXXXXXXXXXXXXXXXXXXXXXXXXXXXXXXXXXXXXXXXXXXXXXXXXXXXXXXXXXXXXXXXXXXXXXXXXXXXXXXXXXXXX----XXXXXXXXXXXXXXXXXXXXXX--XXXXXXXXXXXXXXXXXXXXXXXXXXXXXXXXXXXXXXXXXXXXXXXXXXXXXXX----XXXXXXXXXXXXX
