-o------B-------------------B-X--------------------X----B-------X---------------------X---------------------o-----------X-------X-B------X--B---o-------------B--X-----------X--o-------X-X----------X--
-B-o----o--B-------------------------X--o------X-X----o---------o---------o--o---XB-B--B----B---B-----B-----B---------o-----o------------B----o-----------X--------o---o-----o--------------o-----------
---o-B------------------B---------------------------------------B------------o------o---X-B----------------o------B--------------------o----------------o-----------------------X-------B------B------B-
--X-------------------X-----------X------------------------o-----------------------------B-----------B--------X--------X---X---------------o------------------o---o-B-X---X---o----o-------------B----X-
---o---X-----B--B-oXX----------o---------X--BX--X--XBBo----B------------X-------------------X--B-----------B----------BXo------------B----B----------------X-----B----------------------X-X-B-----------
-----B------X--X------------------------B----B-----------B-------------B------XX------o-----------X-----XX--------o----B-------------oB---------XB------------------X--o-o------X--X-----B--B-B------o--
-----------------------X--o----------B------------------------------------o--o-B--o-------------------------B---------------------XB---X------B--------o---------------X----------B-o-----X--X----X-----
----o--------X-o--------------------Bo-----X------------B------XX--------------------X---------B---B----o---o-------------X------XX-B--oo-----X-------X-X-o---------------X------------X----B-oo-------v
----B---o-X-----------------o-o------o---------------------X------XB----------X------------------o----B-------X---------------------------X--X----------B-------------------------------------o-----o--f
----X-oX-----------X---------------------------B---------------o----X---------------X-B---------o-----------------------------B-------B---o--X--Xo-----B-----------------BBXX-----B-B--B---BX----------f
--------o----X--o-Bo----------X--------X---------X----o----X----------B------Bo------B---------------------o-------X----------------------B---------X-------B-----------------o---B-----X--------------f
----------Xo--------X---o-o-----B----B----o-----B---------B----------o----o---------o-------------BX--X---B-------B-----------X-----B---------------XXX----------B----------B---------------X----------f
-------X-X-----------------X-------------oB-----B---------------X-o---X---------------------------------o---XXXXBB---------X-------o--B---oo--------------------X----------------o-----------------oo-Bf
mXXXXXXXXXXXXXXXXXXXXXXXXXXXXXXXXXXXXXXXXXXXXXXXXXXXXXXXXXXXXXXXXXXXXXXXXXXXXXXXXXXXXXXXXXXXXXXXXXXXXXXXXXXXXXXXXXXXXXXXXXXXXXXXXXXXXXXXXXXXXXXXXXXXXXXXXXXXXXXXXXXXXXXXXXXXXXXXXXXXXXXXXXXXXXXXXXXXXXXf
XXXXXXXXXXXXXXXXXXXXXXXXXXXXXXXXXXXXXXXXXXXXXXXXXXXXXXXXXXXXXXXXXXXXXXXXXXXXXXXXXXXXXXXXXXXXXXXXXXXXXXXXXXXXXXXXXXXXXXXXXXXXXXXXXXXXXXXXXXXXXXXXXXXXXXXXXXXXXXXXXXXXXXXXXXXXXXXXXXXXXXXXXXXXXXXXXXXXXXXX
XXXXXXXXXXXXXXXXXXXXXXXXXXXXXXXXXXXXXXXXXXXXXXXXXXXXXXXXXXXXXXXXXXXXXXXXXXXXXXXXXXXXXXXXXXXXXXXXXXXXXXXXXXXXXXXXXXXXXXXXXXXXXXXXXXXXXXXXXXXXXXXXXXXXXXXXXXXXXXXXXXXXXXXXXXXXXXXXXXXXXXXXXXXXXXXXXXXXXXXX
