-o------B-------------------B-X-------------------------B-------X---------------------X---------------------------------X-------X-B------X------o-------------B--X-----------X--o-------X------------X--
-B-o---------------------------------------------X------------------------o--o---XB---------B---------------B---------o-----o------------B----o-----------X------------o--------------------------------
---o-B------------------B----------------------------------------------------o----------X-B----------------o------B--------------------o----------------------------------------X--------------X------B-
----------o-----------X-----------X------------------------------------------------------B-----------B--------X----------------------------o------------------o-----B-X---X----------------------B----X-
---o---X-----B--B-oXX--------------------X--BX-----XBBo----B------------X-------------------X--B-----------B----------BXo------------B----B----------------X-----o----------------------X-X-------------
-----B------X---------------------------B------------------------------B------X-------o-----------X-----X---------o------------------oB---------XB---------------------o-o------X--X-----------------o--
-------------------------------------B------------------------------------o--o------------------------------B---------------------Xo---X------B--------o---------------X----------B-o-----B--X----X-----
-------------X-o--------------------B------X------------B------XX--------------------X-------o-----B--------o-------------X-----B---B---o-----X---------X-o---------------X-------------------oo-------v
----B---o-------------------o--------o---------------------X------X-----------X------------------o----B-----------------------------------X--X------------------------------------------------o-----o--f
------oX--o--------X------------------------------------------------X---------------------------o--------------------------------------------X--X------B-----------------BXXX-----B-B------B-----------f
----------------o--o-------------------X---------X---------X----------B------Bo------B---------------------o-------X------------------------X-------X-----------------------------B-----X---B----------f
-----------o--------X---o-o----------B----o-----B-------------------------o---------o-------------BX--X---B-------------------X-----B----------------------------B----------B--------------------------f
-----------------------------------------oB-----B---------------X-----X-------------------------------------XXXXBB---------X-------o--B---oo-------------------------------------------------------oo--f
mXXXXXXXXXXXXXXXXXXXXXXXXXXXXXXXXXXXXXXXXXXXXXXXXXXXXXXXXXXXXXXXXXXXXXXXXXXXXXXXXXXXXXXXXXXXXXXXXXXXXXXXXXXXXXXXXXXXXXXXXXXXXXXXXXXXXXXXXXXXXXXXXXXXXXXXXXXXXXXXXXXXXXXXXXXXXXXXXXXXXXXXXXXXXXXXXXXXXXXf
XXXXXXXXXXXXXXXXXXXXXXXXXXXXXXXXXXXXXXXXXXXXXXXXXXXXXXXXXXXXXXXXXXXXXXXXXXXXXXXXXXXXXXXXXXXXXXXXXXXXXXXXXXXXXXXXXXXXXXXXXXXXXXXXXXXXXXXXXXXXXXXXXXXXXXXXXXXXXXXXXXXXXXXXXXXXXXXXXXXXXXXXXXXXXXXXXXXXXXXX
XXXXXXXXXXXXXXXXXXXXXXXXXXXXXXXXXXXXXXXXXXXXXXXXXXXXXXXXXXXXXXXXXXXXXXXXXXXXXXXXXXXXXXXXXXXXXXXXXXXXXXXXXXXXXXXXXXXXXXXXXXXXXXXXXXXXXXXXXXXXXXXXXXXXXXXXXXXXXXXXXXXXXXXXXXXXXXXXXXXXXXXXXXXXXXXXXXXXXXXX
