-------------------------B-------o---------------------------------------------o----------o----------------------------------------XX----------------X-----------o---X----------------------------------
----------------------------------------------o-----------------X----------------------------------------------------------------------------------X-------------------------------------------------B--
-----------o-----------------------------------------------------------------------------------------------------------------------o--------------------------------------------------------------------
---------------------X-------------------X---------------------------o-----------o-------------------------------------------------------X----------------------B------------------------------------B--
-----------------------------------oB---------------X-B------------------o-----------------------o--------------------------o--X----------------------X-------B-------------o-o-o----------------o------
------X----------X----------o----------------------------------------------------B------------------------XXXBBB--------------------------------o-------------------------------------------------------
-------X---------------B---BXBXB-------------------X-----------------o-------------------------BXXXXXX-----X---B-X------o---------B----------o---------o----------------------X-------------------------
------------------------------o-----------o---------------------------------X-XB-------------BXX---o----------------------------X----------o-----X------------------------------o-------------------o--v
--o-------------------------------------------------------X--------------------o----------------------------------------X------------------------------------------------------------------------------f
-----------------------------------X-----------B------------------X--------------------------------------------------------------------------------B---B------------------XBXBXXB-----------B----------f
-------o-----------------------------------------X-B---------------------o----------------o---X---X---------B----------------------------------------------B----------B----X-----------Bo--------------f
-------------------------------B----B------------------------X------------T----B---------B-o--o----------------------------------------------B---------------------------------------B------X----------f
----------------------------------------------B--------o------------------|-------------B---------------------------o------X------------------------------X--------------------------------------------f
-----X-----------B-----------------------o--------------------------------|-------------------B----X-X---------------------------o---o--------------X---------------BB-X---o---------------------------f
m-----------------X----------------------------------B--------E---E------B|------------------------------------------------------o-----------------------------B--------E----------------------------E-X
XXXXXXXXXXXXXXXXXXXXXXXXXXXXXXXXXXXXXXXXXXXXXXXXXXXXXXXXXXXXXXXXXXXXXXXXXX|XXXXXXXXXXXXXXXXXXXXXXXXXXXXXXXXXXXXXXXXXXXXXXXXXXXXXXXXXXXXXXXXXXXXXXXXXXXXXXXXXXXXXXXXXXXXXXXXXXXXXXXXXXXXXXXXXXXXXXXXXXXXX
