----B---------o-Bo---B-X---B--------o--o-X----------------------------o---X--B-B-o------X----o------o-----X-----------------X--------------------o---B----------------------------X----B--o-------------
---------------o-B--------X-----o--o--B--B-B-----X--o--------------------------------------o---------X---B-------------X-----------------------------X--B------------------------------o---------o------
----o---------o-X-----X--------------------------------------------X-----------B-----B-----------X--------X---------------o-----X-----o-B---------B---------------X------------------------X-----B------
-B-B---o------oB-------X-o------B-B------------------------------oB---------------Bo-B----o---B--------o-----------o---------o-------BX-XB-----XB----B------------X-X-----------B----------XBBB-o-------
--X-------------------Bo-------------------X--------------------oB---o----------X----X-------o--o------B-BX-X-----------------------------------------o---------B------------X--XXX------o--------------
----B--------------X----oBB-o----------------------B-X-------------------B---------------------B-----X-o---------------B--------o---------------B---B------oB-----------------B-------------------------
---oB---------B----------------------------o--o----------BB---------X----B---B----X---o--------X----XX---------B-----X------X----------Xo------X-X--------X------o-------X------------o--X--------------
--------o-----X-B-------o-------------X---o--X-----------B-----o------X-------B-------o---Xo---------------o----o--------------------B----Xo---B-------o----o----------------B------------X------------v
-o-B----------B------X-o-B---o------------------------B-----B--o------o----X--------------o------------------X-------------------------B--o-----B-B--X-------------------X------------------------B----f
------Xo-X--X-----o---B-------X----X---X-----------X----XB----o--------B----X--B---o-X--o----------X-----B-----B------------B----------X---------B-B----------------X-o---XX-------------o-----oB------f
---------------------------B---o----------------B--X-X-------------------o-X--------o-------B------------------------------B----X--------------------X----XXXX-XB-------oX--------X----X------o-----B--f
----B--------------B-------------o-------------o---------o------o--Xo----------------X-------X-------o-oX--X---B--o----------o-----------------------X------------------------------------o--------B---f
---B-------------------------o-------o--B----oB------X--B---X---------B------------o-----B------o--------------------------------------------B------------o----oo---------B-------------------o----X---f
------B-------------o------B---------o----------o-----------X---Bo---B------o---B--------------------X------------------------Bo-----------B-B-----------o-X---X--o----------oBX------X-------------B--f
m----------X-B-------B-----E--------o------o---o-----------B--X-----------oo----------------E-------E-BX-B--------------X-----------E---------------X-B------------------------------X-------------oB--X
XXXXXXXXXXXXXXXXXXXXXXXXXXXXXXXXXXXXXXXXXXXXXXXXXXXXXXXXXXXXXXXXXXXXXXXXXXXXXXXXXXXXXXXXXXXXXXXXXXXXXXXXXXXXXXXXXXXXXXXXXXXXXXXXXXXXXXXXXXXXXXXXXXXXXXXXXXXXXXXXXXXXXXXXXXXXXXXXXXXXXXXXXXXXXXXXXXXXXXXX
